########################################
#.#...........#.....#.........#...#...##
#.#.#######.#.###.###.#####.#.###.#.#.##
#.#.#.......#...#.....#.#...#...#...#.##
#.###.#########.#.#####.#.#####.#####.##
#.#...#...#.....#.#.....#.#...#...#...##
#.#.#####.#.#####.#####.#.#.#####.#.####
#...#...#.#.#...........#.#.....#.#...##
#####.#.#.#.###.#########.#.#.###.###.##
#.....#...#...#.#.......#.#.#.....#...##
#.#######.###.###.#####.#.#.#######.#.##
#.#...#.#...#.....#...#...#.#.......#.##
#.#.#.#.#.###########.#####.###.#####.##
#.#.#.#...#.........#.#.....#...#...#.##
#.#.#.#####.###.###.#.#.#####.###.#.#.##
#.#.#.#...#.#.#...#...#.#.......#.#...##
#.#.#.#.#.#.#.###.#####.#####.#.###.####
#...#.#.#.#.#...#.....#.....#.#...#...##
#.###.#.#.#.#.#.#####.#####.#####.######
#...#...#...#.#.#.....#...#.#...#.....##
###.###########.#.###.#.#.#.#.#.###.#.##
#...#...........#.#.....#.#...#...#.#.##
#.#####.#######.#.###############.###.##
#.......#.......#.....................##
########################################
