###################################
#?#.........#.....#...............#
#.###.#####.#.#####.#####.#######.#
#.....#.#...#.....#...#...#.......#
#######.#.#######.#.###.###.#######
#...#...#.......#...#...#.#.....#.#
#.###.#.#######.#####.###.#####.#.#
#.....#...#.....#.....#...#...#...#
#.#######.#.#####.#####.#.#.#.###.#
#.#.....#...#.....#...#.#...#...#.#
#.###.#########.###.#.#.#####.###.#
#...#...........#...#.#...#.#.....#
###.#####.###.#####.#.###.#.#######
#.#.....#...#.....#.#...#.....#...#
#.#####.#####.###.#.###.#####.#.#.#
#.....#.....#...#.#...#...#...#.#.#
#.#.#######.#####.###.#.###.#####.#
#.#...............#...#...........#
###################################
###################################
