########################################
########################################
########################################
########################################
########################################
########################################
########################################
##############......####################
##############......##..........########
##############......##..........########
########............##..........########
########.#####......##..........########
########.#####.....?............########
######....####......##..........########
######....############..........########
######....############..........########
######....############..........########
######....##############################
######....##############################
######....##############################
######....##############################
######....##############################
######....##############################
########################################
########################################
