########################################
########################################
##...##...##...............#######...###
##...................................###
##...##....#...............#######...###
###.######.#############################
###.######.#############################
##...#####.#......###......####.....####
##..................................####
##...#####.#......###......####.....####
##########.########?####################
##########.#############################
####............###################...##
####............############....###...##
####..................................##
####............############....###...##
########.##########################...##
########.###########################.###
########.####################....###.###
######.....##################....###.###
######.....##################....##...##
######...........................##...##
######.....########################...##
########################################
########################################
