◆◆◆◆◆◆◆◆◆◆◆◆◆◆◆◆◆◆◆◆◆◆◆◆◆◆◆◆◆◆◆◆◆◆◆*******************************************************************************************************************░░░░*************░░░░░░░░░░░░░░░░░░░░░░░░░░░░░░░░░░░░░░**************◆◆◆◆◆◆◆◆◆◆◆◆◆◆◆◆◆◆◆◆◆◆◆◆◆◆◆◆◆◆◆
◆◆◆◆◆◆◆◆◆◆◆◆◆◆◆◆◆◆◆◆◆◆◆◆◆◆◆◆◆◆◆◆◆◆◆********************************************************************************************************************░░**************░░░░░░░░░░░░░░░░░░░░░░░░░░░░░░░░░░░░░░***************◆◆◆◆◆◆◆◆◆◆◆◆◆◆◆◆◆◆◆◆◆◆◆◆◆◆◆◆◆◆
◆◆◆◆◆◆◆◆◆◆◆◆◆◆◆◆◆◆◆◆◆◆◆◆◆◆◆◆◆◆◆◆◆◆◆********************************************************************************************************************░░**************░░░░░░░░░░░░░░░░░░░░░░░░░░░░░░░░░░░░░░░***************◆◆◆◆◆◆◆◆◆◆◆◆◆◆◆◆◆◆◆◆◆◆◆◆◆◆◆◆◆
◆◆◆◆◆◆◆◆◆◆◆◆◆◆◆◆◆◆◆◆◆◆◆◆◆◆◆◆◆◆◆◆◆◆*********************************************************************************************************************░*************...░░░░░░░░░░░░░░░░░░░░░░░░░░░░░░░░░░░░░░***************◆◆◆◆◆◆◆◆◆◆◆◆◆◆◆◆◆◆◆◆◆◆◆◆◆◆◆◆◆
◆◆◆◆◆◆◆◆◆◆◆◆◆◆◆◆◆◆◆◆◆◆◆◆◆◆◆◆◆◆◆◆◆◆**********************************************************************************************************************************....░░░░░░░░░░░░░░░░░░░░░░░░░░░░░░░░░░░░░░░***************◆◆◆◆◆◆◆◆◆◆◆◆◆◆◆◆◆◆◆◆◆◆◆◆◆◆◆◆
◆◆◆◆◆◆◆◆◆◆◆◆◆◆◆◆◆◆◆◆◆◆◆◆◆◆◆◆◆◆◆◆◆**********************************************************************************************************************************.....░░░░░░░░░░░░░░░░░░░░░░░░░░░░░░░░░░░░░░░░**************◆◆◆◆◆◆◆◆◆◆◆◆◆◆◆◆◆◆◆◆◆◆◆◆◆◆◆◆
◆◆◆◆◆◆◆◆◆◆◆◆◆◆◆◆◆◆◆◆◆◆◆◆◆◆◆◆◆◆◆◆***********************************************************************************************************************************....░░░░░░░░░░░░░░░░░░░░░░░░░░░░░░░░░░░░░░░░░░**************◆◆◆◆◆◆◆◆◆◆◆◆◆◆◆◆◆◆◆◆◆◆◆◆◆◆◆
◆◆◆◆◆◆◆◆◆◆◆◆◆◆◆◆◆◆◆◆◆◆◆◆◆◆◆◆◆◆◆************************************************************************************************************************************...░░░░░░░░░░░░░░░░░░░░░░░░░░░░░░░░░░░░░░░░░░░░*************◆◆◆◆◆◆◆◆◆◆◆◆◆◆◆◆◆◆◆◆◆◆◆◆◆◆◆
◆◆◆◆◆◆◆◆◆◆◆◆◆◆◆◆◆◆◆◆◆◆◆◆◆◆◆◆◆************************************************************************************************************************************░░░░░░░░░░░░░░░░░░░░░░░░░░░░░░░░░░░░░░░░░░░░░░░░░░*************◆◆◆◆◆◆◆◆◆◆◆◆◆◆◆◆◆◆◆◆◆◆◆◆◆◆
◆◆◆◆◆◆◆◆◆◆◆◆◆◆◆◆◆◆◆◆◆◆◆◆◆◆*************************************************************************************************************************************░░░░░░░░░░░░░░░░░░░░░░░░░░░░░░░░░░░░░░░░░░░░░░░░░░░░░░░**********◆◆◆◆◆◆◆◆◆◆◆◆◆◆◆◆◆◆◆◆◆◆◆◆◆◆
◆◆◆◆◆◆◆◆◆◆◆***************************************************************************************************************************************************░░░░░░░░░░░░░░░░░░░░░░░░░░░░░░░░░░░░░░░░░░░░░░░░░░░░░░░░░░********◆◆◆◆◆◆◆◆◆◆◆◆◆◆◆◆◆◆◆◆◆◆◆◆◆◆
◆◆◆◆◆◆◆◆*****************************************************************************************************************************************************░░░░░░░░░░░░░░░░░░░░░░░░░░░░░░░░░░░░░░░░░░░░░░░░░░░░░░░░░░░░░░******◆◆◆◆◆◆◆◆◆◆◆◆◆◆◆◆◆◆◆◆◆◆◆◆◆
◆◆◆◆◆◆******************************************************************************************************************************************************░░░░░░░░░░░░░░░░░░░░░░░░░░░░░░░░░░░░░░░░░░░░░░░░░░░░░░░░░░░░░░░░░░***◆◆◆◆◆◆◆◆◆◆◆◆◆◆◆◆◆◆◆◆◆◆◆◆◆
◆◆◆◆*********************************************************************************************************************************************************░░░░░░░░░░░░░░░░░░░░░░░░░░░░░░░░░░░░░░░░░░░░░░░░░░░░░░░░░░░░░░░░░░**◆◆◆◆◆◆◆◆◆◆◆◆◆◆◆◆◆◆◆◆◆◆◆◆◆
◆◆░░░**********************************************************************************************************************************************************░░░░░░░░░░░░░░░░░░░░░░░░░░░░░░░░░░░░░░░░░░░░░░░░░░░░░░░░░░░░░░░***◆◆◆◆◆◆◆◆◆◆◆◆◆◆◆◆◆◆◆◆◆◆◆◆◆
░░░░░░*******************░***************************************************************************************************************************************░░░░░░░░░░░░░░░░░░░░░░░░░░░░░░░░░░░░░░░░░░░░░░░░░░░░░░░░░░░░░***◆◆◆◆◆◆◆◆◆◆◆◆◆◆◆◆◆◆◆◆◆◆◆◆◆
░░░░░░*****************░░░░****************************************************************************************************************************************░░░░░░░░░░░░░░░░░░░░░░░░░░░░░░░░░░░░░░░░░░░░░░░░░░░░░░░░░░****◆◆◆◆◆◆◆◆◆◆◆◆◆◆◆◆◆◆◆◆◆◆◆◆◆
░░░░░░****************░░░░░░*****************************************************************************************************************************************░░░░░░░░░░░░░░░░░░░░░░░░░░░░░░░░░░░░░░░░░░░░░░░░░░░░░░░*****◆◆◆◆◆◆◆◆◆◆◆◆◆◆◆◆◆◆◆◆◆◆◆◆◆
░░░░░░░**************░░░░░░░******************************************************************************************************************************************░░░░░░░░░░░░░░░░░░░░░░░░░░░░░░░░░░░░░░░░░░░░░░░░░░░░*******◆◆◆◆◆◆◆◆◆◆◆◆◆◆◆◆◆◆◆◆◆◆◆◆◆
░░░░░░░*************░░░░░░░░░******************************************************************************************************************************************░░░░░░░░░░░░░░░░░░░░░░░░░░░░░░░░░░░░░░░░░░░░░░░░░********◆◆◆◆◆◆◆◆◆◆◆◆◆◆◆◆◆◆◆◆◆◆◆◆◆◆
░░░░░░░░************░░░░░░░░░*******************************************************************************************************************************************░░░░░░░░░░░░░░░░░░░░░░░░░░░░░░░░░░░░░░░░░░░░░░░*********◆◆◆◆◆◆◆◆◆◆◆◆◆◆◆◆◆◆◆◆◆◆◆◆◆◆
░░░░░░░░***********░░░░░░░░░░░*******************************************************************************************************************************************░░░░░░░░░░░░░░░░░░░░░░░░░░░░░░░░░░░░░░░░░░░░░**********◆◆◆◆◆◆◆◆◆◆◆◆◆◆◆◆◆◆◆◆◆◆◆◆◆◆
░░░░░░░░░*********░░░░░░░░░░░░*******************************************************************************************************************************************░░░░░░░░░░░░░░░░░░░░░░░░░░░░░░░░░░░░░░░░░░░░░**********◆◆◆◆◆◆◆◆◆◆◆◆◆◆◆◆◆◆◆◆◆◆◆◆◆◆
░░░░░░░░░░*******░░░░░░░░░░░░░********************************************************************************************************************************************░░░░░░░░░░░░░░░░░░░░░░░░░░░░░░░░░░░░░░░░░░░***********◆◆◆◆◆◆◆◆◆◆◆◆◆◆◆◆◆◆◆◆◆◆◆◆◆◆
░░░░░░░░░░░░░**░░░░░░░░░░░░░░░░*******************************************************************************************************************************************░░░░░░░░░░░░░░░░░░░░░░░░░░░░░░░░░░░░░░░░░░░**********◆◆◆◆◆◆◆◆◆◆◆◆◆◆◆◆◆◆◆◆◆◆◆◆◆◆◆
░░░░░░░░░░░░░░░░░░░░░░░░░░░░░░░░******************************************************************************************************************************************░░░░░░░░░░░░░░░░░░░░░░░░░░░░░░░░░░░░░░░░░░░**********◆◆◆◆◆◆◆◆◆◆◆◆◆◆◆◆◆◆◆◆◆◆◆◆◆◆◆
░░░░░░░░░░░░░░░░░░░░░░░░░░░░░░░░*******************************************************************************************************************************************░░░░░░░░░░░░░░░░░░░░░░░░░░░░░░░░░░░░░░░░░░**********◆◆◆◆◆◆◆◆◆◆◆◆◆◆◆◆◆◆◆◆◆◆◆◆◆◆◆
░░░░░░░░░░░░░░░░░░░░░░░░░░░░░░░░░******************************************************************************************************************************************░░░░░░░░░░░░░░░░░░░░░░░░░░░░░░░░░░░░░░░░░░░********◆◆◆◆◆◆◆◆◆◆◆◆◆◆◆◆◆◆◆◆◆◆◆◆◆◆◆◆
░░░░░░░░░░░░░░░░░░░░░░░░░░░░░░░░░░*****************************************************************************************************************************************░░░░░░░░░░░░░░░░░░░░░░░░░░░░░░░░░░░░░░░░░░░********◆◆◆◆◆◆◆◆◆◆◆◆◆◆◆◆◆◆◆◆◆◆◆◆◆◆◆◆
░░░░░░░░░░░░░░░░░░░░░░░░░░░░░░░░░░░****************************************************************************************************************************************░░░░░░░░░░░░░░░░░░░░░░░░░░░░░░░░░░░░░░░░░░░░*******◆◆◆◆◆◆◆◆◆◆◆◆◆◆◆◆◆◆◆◆◆◆◆◆◆◆◆◆
░░░░░░░░░░░░░░░░░░░░░░░░░░░░░░░░░░░░░*************░************************************************************************************************************************░░░░░░░░░░░░░░░░░░░░░░░░░░░░░░░░░░░░░░░░░░░░░*****◆◆◆◆◆◆◆◆◆◆◆◆◆◆◆◆◆◆◆◆◆◆◆◆◆◆◆◆◆
░░░░░░░░░░░░░░░░░░░░░░░░░░░░░░░░░░░░░░░░░*******░░░************************************************************************************************************************░░░░░░░░░░░░░░░░░░░░░░░░░░░░░░░░░░░░░░░░░░░░░░░***◆◆◆◆◆◆◆◆◆◆◆◆◆◆◆◆◆◆◆◆◆◆◆◆◆◆◆◆◆
░░░░░░░░░░░░░░░░░░░░░░░░░░░░░░░░░░░░░░░░░░░░░░░░░░░░***********************************************************************************************************************░░░░░░░░░░░░░░░░░░░░░░░░░░░░░░░░░░░░░░░░░░░░░░░░░░◆◆◆◆◆◆◆◆◆◆◆◆◆◆◆◆◆◆◆◆◆◆◆◆◆◆◆◆◆
░░░░░░░░░░░░░░░░░░░░░░░░░░░░░░░░░░░░░░░░░░░░░░░░░░░░***********************************************************************************************************************░░░░░░░░░░░░░░░░░░░░░░░░░░░░░░░░░░░░░░░░░░░░░░░░░◆◆◆◆◆◆◆◆◆◆◆◆◆◆◆◆◆◆◆◆◆◆◆◆◆◆◆◆◆◆
░░░░░░░░░░░░░░░░░░░░░░░░░░░░░░░░░░░░░░░░░░░░░░░░░░░░░*********************************************************************************************************************░░░░░░░░░░░░░░░░░░░░░░░░░░░░░░░░░░░░░░░░░░░░░░░░░░◆◆◆◆◆◆◆◆◆◆◆◆◆◆◆◆◆◆◆◆◆◆◆◆◆◆◆◆◆◆
░░░░░░░░░░░░░░░░░░░░░░░░░░░░░░░░░░░░░░░░░░░░░░░░░░░░░*********************************************************************************************************************░░░░░░░░░░░░░░░░░░░░░░░░░░░░░░░░░░░░░░░░░░░░░░░░░░◆◆◆◆◆◆◆◆◆◆◆◆◆◆◆◆◆◆◆◆◆◆◆◆◆◆◆◆◆◆
░░░░░░░░░░░░░░░░░░░░░░░░░░░░░░░░░░░░░░░░░░░░░░░░░░░░░░********************************************************************************************************************░░░░░░░░░░░░░░░░░░░░░░░░░░░░░░░░░░░░░░░░░░░░░░░░░░◆◆◆◆◆◆◆◆◆◆◆◆◆◆◆◆◆◆◆◆◆◆◆◆◆◆◆◆◆◆
░░░░░░░░░░░░░░░░░░░░░░░░░░░░░░░░░░░░░░░░░░░░░░░░░░░░░░░░*****************************************************************************************************************░░░░░░░░░░░░░░░░░░░░░░░░░░░░░░░░░░░░░░░░░░░░░░░░░░░◆◆◆◆◆◆◆◆◆◆◆◆◆◆◆◆◆◆◆◆◆◆◆◆◆◆◆◆◆◆
░░░░░░░░░░░░░░░░░░░░░░░░░░░░░░░░░░░░░░░░░░░░░░░░░░░░░░░░░*****************************************************************************************************************░░░░░░░░░░░░░░░░░░░░░░░░░░░░░░░░░░░░░░░░░░░░░░░░░░◆◆◆◆◆◆◆◆◆◆◆◆◆◆◆◆◆◆◆◆◆◆◆◆◆◆◆◆◆◆
░░░░░░░░░░░░░░░░░░░░░░░░░░░░░░░░░░░░░░░░░░░░░░░░░░░░░░░░*******************************************************************************************************************░░░░░░░░░░░░░░░░░░░░░░░░░░░░░░░░░░░░░░░░░░░░░░░░░◆◆◆◆◆◆◆◆◆◆◆◆◆◆◆◆◆◆◆◆◆◆◆◆◆◆◆◆◆◆
░░░░░░░░░░░░░░░░░░░░░░░░░░░░░░░░░░░░░░░░░░░░░░░░░░░░░░░░********************************************************************************************************************░░░░░░░░░░░░░░░░░░░░░░░░░░░░░░░░░░░░░░░░░░░░░░░░◆◆◆◆◆◆◆◆◆◆◆◆◆◆◆◆◆◆◆◆◆◆◆◆◆◆◆◆◆◆
░░░░░░░░░░░░░░░░░░░░░░░░░░░░░░░░░░░░░░░░░░░░░░░░░░░░░░░░*********************************************************************************************************************░░░░░░░░░░░░░░░░░░░░░░░░░░░░░░░░░░░░░░░░░░░░░**◆◆◆◆◆◆◆◆◆◆◆◆◆◆◆◆◆◆◆◆◆◆◆◆◆◆◆◆◆◆
░░░░░░░░░░░░░░░░░░░░░░░░░░░░░░░░░░░░░░░░░░░░░░░░░░░░░░░░**********************************************************************************************************************░░░░░░░░░░░░░░░░░░░░░░░░░░░░░░░░░░░░░░░░░*****◆◆◆◆◆◆◆◆◆◆◆◆◆◆◆◆◆◆◆◆◆◆◆◆◆◆◆◆◆◆
◆◆░░░░░░░░░░░░░░░░░░░░░░░░░░░░░░░░░░░░░░░░░░░░░░░░░░░░░░**********************************************************************************************************************░░░░░░░░░░░░░░░░░░░░░░░░░░░░░░░░░░░░░░░*******◆◆◆◆◆◆◆◆◆◆◆◆◆◆◆◆◆◆◆◆◆◆◆◆◆◆◆◆◆◆
◆◆◆░░░░░░░░░░░░░░░░░░░░░░░░░░░░░░░░░░░░░░░░░░░░░░░░░░░░░***********************************************************************************************************************░░░░░░░░░░░░░░░░░░░░░░░░░░░░░░░░░░░░**********◆◆◆◆◆◆◆◆◆◆◆◆◆◆◆◆◆◆◆◆◆◆◆◆◆◆◆◆◆
◆◆◆◆◆░░░░░░░░░░░░░░░░░░░░░░░░░░░░░░░░░░░░░░░░░░░░░░░░░░░***********************************************************************************************************************░░░░░░░░░░░░░░░░░░░░░░░░░░░░░░░░░░************◆◆◆◆◆◆◆◆◆◆◆◆◆◆◆◆◆◆◆◆◆◆◆◆◆◆◆◆◆
◆◆◆◆◆◆◆░░░░░░░░░░░░░░░░░░░░░░░░░░░░░░░░░░░░░░░░░░░░░░░░░************************************************************************************************************************░░░░***********░░░░░░░░░░░░░░░░░**************◆◆◆◆◆◆◆◆◆◆◆◆◆◆◆◆◆◆◆◆◆◆◆◆◆◆◆◆
◆◆◆◆◆◆◆◆◆░░░░░░░░░░░░░░░░░░░░░░░░░░░░░░░░░░░░░░░░░░░░░░░************************************************************************************************************************░░***************░░░░░░░░░░░░░░░**************◆◆◆◆◆◆◆◆◆◆◆◆◆◆◆◆◆◆◆◆◆◆◆◆◆◆◆◆
◆◆◆◆◆◆◆◆◆◆░░░░░░░░░░░░░░░░░░░░░░░░░░░░░░░░░░░░░░░░░░░░░░************************************************************************************************************************░*****************░░░░░░░░░░░░░****************◆◆◆◆◆◆◆◆◆◆◆◆◆◆◆◆◆◆◆◆◆◆◆◆◆◆◆
◆◆◆◆◆◆◆◆◆◆◆◆░░░░░░░░░░░░░░░░░░░░░░░░░░░░░░░░░░░░░░░░░░░░*******************************************************************************************************************************************░░░░░░░░░░░*****************◆◆◆◆◆◆◆◆◆◆◆◆◆◆◆◆◆◆◆◆◆◆◆◆◆◆◆
◆◆◆◆◆◆◆◆◆◆◆◆◆░░░░░░░░░░░░░░░░░░░░░░░░░░░░░░░░░░░░░░░░░░░░*******************************************************************************************************************************************░░░░░░░░░░******************◆◆◆◆◆◆◆◆◆◆◆◆◆◆◆◆◆◆◆◆◆◆◆◆◆◆
◆◆◆◆◆◆◆◆◆◆◆◆◆◆◆░░░░░░░░░░░░░░░░░░░░░░░░░░░░░░░░░░░░░░░░░░*******************************************************************************************************************************************░░░░░░░░░********************◆◆◆◆◆◆◆◆◆◆◆◆◆◆◆◆◆◆◆◆◆◆◆◆◆
◆◆◆◆◆◆◆◆◆◆◆◆◆◆◆◆░░░░░░░░░░░░░░░░░░░░░░░░░░░░░░░░░░░░░░░░░********************************************************************************************************************************************░░░░░░░░*********************◆◆◆◆◆◆◆◆◆◆◆◆◆◆◆◆◆◆◆◆◆◆◆◆
◆◆◆◆◆◆◆◆◆◆◆◆◆◆◆◆◆◆░░░░░░░░░░░░░░░░░░░░░░░░░░░░░░░░░░░░░░░░*******************************************************************************************************************************************░░░░░░░░*********************◆◆◆◆◆◆◆◆◆◆◆◆◆◆◆◆◆◆◆◆◆◆◆◆
◆◆◆◆◆◆◆◆◆◆◆◆◆◆◆◆◆◆◆░░░░░░░░░░░░░░░░░░░░░░░░░░░░░░░░░░░░░░░********************************************************************************************************************************************░░░░░░***********************◆◆◆◆◆◆◆◆◆◆◆◆◆◆◆◆◆◆◆◆◆◆◆
◆◆◆◆◆◆◆◆◆◆◆◆◆◆◆◆◆◆◆◆◆░░░░░░░░░░░░░░░░░░░░░░░░░░░░░░░░░░░░░░*******************************************************************************************************************************************░░░░░░************************◆◆◆◆◆◆◆◆◆◆◆◆◆◆◆◆◆◆◆◆◆◆
◆◆◆◆◆◆◆◆◆◆◆◆◆◆◆◆◆◆◆◆◆◆░░░░░░░░░░░░░░░░░░░░░░░░░░░░░░░░░░░░░░******************************************************************************************************************************************░░░░░░*************************◆◆◆◆◆◆◆◆◆◆◆◆◆◆◆◆◆◆◆◆◆
◆◆◆◆◆◆◆◆◆◆◆◆◆◆◆◆◆◆◆◆◆◆◆░░░░░░░░░░░░░░░░░░░░░░░░░░░░░░░░░░░░░░******************************************************************************************************************************************░░░░***************************◆◆◆◆◆◆◆◆◆◆◆◆◆◆◆◆◆◆◆◆
◆◆◆◆◆◆◆◆◆◆◆◆◆◆◆◆◆◆◆◆◆◆◆◆◆░░░░░░░░░░░░░░░░░░░░░░░░░░░░░░░░░░░░░░****************************************************************************************************************************************░░░░****************************◆◆◆◆◆◆◆◆◆◆◆◆◆◆◆◆◆◆◆
◆◆◆◆◆◆◆◆◆◆◆◆◆◆◆◆◆◆◆◆◆◆◆◆◆◆░░░░░░░░░░░░░░░░░░░░░░░░░░░░░░░░░░░░░░░***************************************************************************************************************************************░░******************************◆◆◆◆◆◆◆◆◆◆◆◆◆◆◆◆◆◆
◆◆◆◆◆◆◆◆◆◆◆◆◆◆◆◆◆◆◆◆◆◆◆◆◆◆◆░░░░░░░░░░░░░░░░░░░░░░░░░░░░░░░░░░░░░░░░**********************************************************************************************************************************************************************◆◆◆◆◆◆◆◆◆◆◆◆◆◆◆◆◆
◆◆◆◆◆◆◆◆◆◆◆◆◆◆◆◆◆◆◆◆◆◆◆◆◆◆◆◆◆░░░░░░░░░░░░░░░░░░░░░░░░░░░░░░░░░░░░░░░░*********************************************************************************************************************************************************************◆◆◆◆◆◆◆◆◆◆◆◆◆◆◆◆
◆◆◆◆◆◆◆◆◆◆◆◆◆◆◆◆◆◆◆◆◆◆◆◆◆◆◆◆◆◆░░░░░░░░░░░░░░░░░░░░░░░░░░░░░░░░░░░░░░░░░********************************************************************************************************************************************************************◆◆◆◆◆◆◆◆◆◆◆◆◆◆◆
◆◆◆◆◆◆◆◆◆◆◆◆◆◆◆◆◆◆◆◆◆◆◆◆◆◆◆◆◆◆◆░░░░░░░░░░░░░░░░░░░░░░░░░░░░░░░░░░░░░░░░░*********************************************************************************************************************************************************************◆◆◆◆◆◆◆◆◆◆◆◆◆
◆◆◆◆◆◆◆◆◆◆◆◆◆◆◆◆◆◆◆◆◆◆◆◆◆◆◆◆◆◆◆◆◆░░░░░░░░░░░░░░░░░░░░░░░░░░░░░░░░░░░░░░░**********************************************************************************************************************************************************************◆◆◆◆◆◆◆◆◆◆◆◆
◆◆◆◆◆◆◆◆◆◆◆◆◆◆◆◆◆◆◆◆◆◆◆◆◆◆◆◆◆◆◆◆◆◆░░░░░░░░░░░░░░░░░░░░░░░░░░░░░░░░░░░░░░░**********************************************************************************************************************************************************************◆◆◆◆◆◆◆◆◆◆◆
◆◆◆◆◆◆◆◆◆◆◆◆◆◆◆◆◆◆◆◆◆◆◆◆◆◆◆◆◆◆◆◆◆◆◆░░░░░░░░░░░░░░░░░░░░░░░░░░░░░░░░░░░░░░***********************************************************************************************************************************************************************◆◆◆◆◆◆◆◆◆◆
◆◆◆◆◆◆◆◆◆◆◆◆◆◆◆◆◆◆◆◆◆◆◆◆◆◆◆◆◆◆◆◆◆◆◆◆░░░░░░░░░░░░░░░░░░░░░░░░░░░░░░░░░░░░░░***********************************************************************************************************************************************************************◆◆◆◆◆◆◆◆◆
◆◆◆◆◆◆◆◆◆◆◆◆◆◆◆◆◆◆◆◆◆◆◆◆◆◆◆◆◆◆◆◆◆◆◆◆░░░░░░░░░░░░░░░░░░░░░░░░░░░░░░░░░░░░░░░░**********************************************************************************************************************************************************************◆◆◆◆◆◆◆◆
◆◆◆◆◆◆◆◆◆◆◆◆◆◆◆◆◆◆◆◆◆◆◆◆◆◆◆◆◆◆◆◆◆◆◆◆◆░░░░░░░░░░░░░░░░░░░░░░░░░░░░░░░░░░░░░░░***********************************************************************************************************************************************************************◆◆◆◆◆◆◆
◆◆◆◆◆◆◆◆◆◆◆◆◆◆◆◆◆◆◆◆◆◆◆◆◆◆◆◆◆◆◆◆◆◆◆◆◆◆░░░░░░░░░░░░░░░░░░░░░░░░░░░░░░░░░░░░░░░***********************************************************************************************************************************************************************◆◆◆◆◆◆
◆◆◆◆◆◆◆◆◆◆◆◆◆◆◆◆◆◆◆◆◆◆◆◆◆◆◆◆◆◆◆◆◆◆◆◆◆◆░░░░░░░░░░░░░░░░░░░░░░░░░░░░░░░░░░░░░░░***********************************************************************************************************************************************************************◆◆◆◆◆◆
◆◆◆◆◆◆◆◆◆◆◆◆◆◆◆◆◆◆◆◆◆◆◆◆◆◆◆◆◆◆◆◆◆◆◆◆◆◆░░░░░░░░░░░░░░░░░░░░░░░░░░░░░░░░░░░░░░░************************************************************************************************************************************************************************◆◆◆◆◆
◆◆◆◆◆◆◆◆◆◆◆◆◆◆◆◆◆◆◆◆◆◆◆◆◆◆◆◆◆◆◆◆◆◆◆◆◆◆◆░░░░░░░░░░░░░░░░░░░░░░░░░░░░░░░░░░░░░░*************************************************************************************************************************************************************************◆◆◆◆
◆◆◆◆◆◆◆◆◆◆◆◆◆◆◆◆◆◆◆◆◆◆◆◆◆◆◆◆◆◆◆◆◆◆◆◆◆◆◆░░░░░░░░░░░░░░░░░░░░░░░░░░░░░░░░░░░░░░░*************************************************************************************************************************************************************************◆◆◆
◆◆◆◆◆◆◆◆◆◆◆◆◆◆◆◆◆◆◆◆◆◆◆◆◆◆◆◆◆◆◆◆◆◆◆◆◆◆◆░░░░░░░░░░░░░░░░░░░░░░░░░░░░░░░░░░░░░░░**************************************************************************************************************************************************************************◆◆
◆◆◆◆◆◆◆◆◆◆◆◆◆◆◆◆◆◆◆◆◆◆◆◆◆◆◆◆◆◆◆◆◆◆◆◆◆◆◆░░░░░░░░░░░░░░░░░░░░░░░░░░░░░░░░░░░░░░░***************************************************************************************************************************************************************************◆
◆◆◆◆◆◆◆◆◆◆◆◆◆◆◆◆◆◆◆◆◆◆◆◆◆◆◆◆◆◆◆◆◆◆◆◆◆◆◆░░░░░░░░░░░░░░░░░░░░░░░░░░░░░░░░░░░░░░░░**************************************************************************************************************************************************************************◆
◆◆◆◆◆◆◆◆◆◆◆◆◆◆◆◆◆◆◆◆◆◆◆◆◆◆◆◆◆◆◆◆◆◆◆◆◆◆◆░░░░░░░░░░░░░░░░░░░░░░░░░░░░░░░░░░░░░░░░***************************************************************************************************************************************************************************
◆◆◆◆◆◆◆◆◆◆◆◆◆◆◆◆◆◆◆◆◆◆◆◆◆◆◆◆◆◆◆◆◆◆◆◆◆◆░░░░░░░░░░░░░░░░░░░░░░░░░░░░░░░░░░░░░░░░░***************************************************************************************************************************************************************************
◆◆◆◆◆◆◆◆◆◆◆◆◆◆◆◆◆◆◆◆◆◆◆◆◆◆◆◆◆◆◆◆◆◆◆◆◆◆░░░░░░░░░░░░░░░░░░░░░░░░░░░░░░░░░░░░░░░░░░**************************************************************************************************************************************************************************
◆◆◆◆◆◆◆◆◆◆◆◆◆◆◆◆◆◆◆◆◆◆◆◆◆◆◆◆◆◆◆◆◆◆◆◆◆◆░░░░░░░░░░░░░░░░░░░░░░░░░░░░░░░░░░░░░░░░░░░*************************************************************************************************************************************************************************
◆◆◆◆◆◆◆◆◆◆◆◆◆◆◆◆◆◆◆◆◆◆◆◆◆◆◆◆◆◆◆◆◆◆◆◆◆░░░░░░░░░░░░░░░░░░░░░░░░░░░░░░░░░░░░░░░░░░░░*************************************************************************************************************************************************************************
◆◆◆◆◆◆◆◆◆◆◆◆◆◆◆◆◆◆◆◆◆◆◆◆◆◆◆◆◆◆◆◆◆◆◆◆◆░░░░░░░░░░░░░░░░░░░░░░░░░░░░░░░░░░░░░░░░░░░░░************************************************************************************************************************************************************************
◆◆◆◆◆◆◆◆◆◆◆◆◆◆◆◆◆◆◆◆◆◆◆◆◆◆◆◆◆◆◆◆◆◆◆◆░░░░░░░░░░░░░░░░░░░░░░░░░░░░░░░░░░░░░░░░░░░░░░░***********************************************************************************************************************************************************************
◆◆◆◆◆◆◆◆◆◆◆◆◆◆◆◆◆◆◆◆◆◆◆◆◆◆◆◆◆◆◆◆◆◆◆◆░░░░░░░░░░░░░░░░░░░░░░░░░░░░░░░░░░░░░░░░░░░░░░░░░*********************************************************************************************************************************************************************
◆◆◆◆◆◆◆◆◆◆◆◆◆◆◆◆◆◆◆◆◆◆◆◆◆◆◆◆◆◆◆◆◆◆◆░░░░░░░░░░░░░░░░░░░░░░░░░░░░░░░░░░░░░░░░░░░░░░░░░░░░*******************************************************************************************************************************************************************
◆◆◆◆◆◆◆◆◆◆◆◆◆◆◆◆◆◆◆◆◆◆◆◆◆◆◆◆◆◆◆◆◆◆◆░░░░░░░░░░░░░░░░░░░░░░░░░░░░░░░░░░░░░░░░░░░░░░░░░░░░░░*****************************************************************************************************************************************************************
◆◆◆◆◆◆◆◆◆◆◆◆◆◆◆◆◆◆◆◆◆◆◆◆◆◆◆◆◆◆◆◆◆◆░░░░░░░░░░░░░░░░░░░░░░░░░░░░░░░░░░░░░░░░░░░░░░░░░░░░░░░░░░**************************************************************************************************************************************************************
◆◆◆◆◆◆◆◆◆◆◆◆◆◆◆◆◆◆◆◆◆◆◆◆◆◆◆◆◆◆◆◆◆◆░░░░░░░░░░░░░░░░░░░░░░░░░░░░░░░░░░░░░░░░░░░░░░░░░░░░░░░░░***************************************************************************************************************************************************************
◆◆◆◆◆◆◆◆◆◆◆◆◆◆◆◆◆◆◆◆◆◆◆◆◆◆◆◆◆◆◆◆◆░░░░░░░░░░░░░░░░░░░░░░░░░░░░░░░░░░░░░░░░░░░░░░░░░░░░░░░░*****************************************************************************************************************************************************************
◆◆◆◆◆◆◆◆◆◆◆◆◆◆◆◆◆◆◆◆◆◆◆◆◆◆◆◆◆◆◆◆░░░░░░░░░░░░░░░░░░░░░░░░░░░░░░░░░░░░░░░░░░░░░░░░░░░░░░░░******************************************************************************************************************************************************************
◆◆◆◆◆◆◆◆◆◆◆◆◆◆◆◆◆◆◆◆◆◆◆◆◆◆◆◆◆◆◆◆░░░░░░░░░░░░░░░░░░░░░░░░░░░░░░░░░░░░░░░░░░░░░░░░░░░░░░░*******************************************************************************************************************************************************************
◆◆◆◆◆◆◆◆◆◆◆◆◆◆◆◆◆◆◆◆◆◆◆◆◆◆◆◆◆◆◆░░░░░░░░░░░░░░░░░░░░░░░░░░░░░░░░░░░░░░░░░░░░░░░░░░░░░░░********************************************************************************************************************************************************************
◆◆◆◆◆◆◆◆◆◆◆◆◆◆◆◆◆◆◆◆◆◆◆◆◆◆◆◆◆◆░░░░░░░░░░░░░░░░░░░░░░░░░░░░░░░░░░░░░░░░░░░░░░░░░░░░░░░░********************************************************************************************************************************************************************
◆◆◆◆◆◆◆◆◆◆◆◆◆◆◆◆◆◆◆◆◆◆◆◆◆◆◆◆◆░░░░░░░░░░░░░░░░░░░░░░░░░░░░░░░░░░░░░░░░░░░░░░░░░░░░░░░░*********************************************************************************************************************************************************************
◆◆◆◆◆◆◆◆◆◆◆◆◆◆◆◆◆◆◆◆◆◆◆◆◆◆◆◆◆░░░░░░░░░░░░░░░░░░░░░░░░░░░░░░░░░░░░░░░░░░░░░░░░░░░░░░░░*********************************************************************************************************************************************************************
◆◆◆◆◆◆◆◆◆◆◆◆◆◆◆◆◆◆◆◆◆◆◆◆◆◆◆◆░░░░░░░░░░░░░░░░░░░░░░░░░░░░░░░░░░░░░░░░░░░░░░░░░░░░░░░░**********************************************************************************************************************************************************************
◆◆◆◆◆◆◆◆◆◆◆◆◆◆◆◆◆◆◆◆◆◆◆◆◆◆◆░░░░░░░***░░░░░░░░░░░░░░░░░░░░░░░░░░░░░░░░░░░░░░░░░░░░░░░**********************************************************************************************************************************************************************
◆◆◆◆◆◆◆◆◆◆◆◆◆◆◆◆◆◆◆◆◆◆◆◆◆◆░░░░░*********░░░░░░░░░░░░░░░░░░░░░░░░░░░░░░░░░░░░░░░░░░░░**********************************************************************************************************************************************************************
◆◆◆◆◆◆◆◆◆◆◆◆◆◆◆◆◆◆◆◆◆◆◆◆◆░░░░░***********░░░░░░░░░░░░░░░░░░░░░░░░░░░░░░░░░░░░░░░░░░░**********************************************************************************************************************************************************************
◆◆◆◆◆◆◆◆◆◆◆◆◆◆◆◆◆◆◆◆◆◆◆◆◆░░░░************░░░░░░░░░░░░░░░░░░░░░░░░░░░░░░░░░░░░░░░░░░░**********************************************************************************************************************************************************************
◆◆◆◆◆◆◆◆◆◆◆◆◆◆◆◆◆◆◆◆◆◆◆◆░░░░**************░░░░░░░░░░░░░░░░░░░░░░░░░░░░░░░░░░░░░░░░░░**********************************************************************************************************************************************************************
◆◆◆◆◆◆◆◆◆◆◆◆◆◆◆◆◆◆◆◆◆◆◆**░░***************░░░░░░░░░░░░░░░░░░░░░░░░░░░░░░░░░░░░░░░░░░░*********************************************************************************************************************************************************************
◆◆◆◆◆◆◆◆◆◆◆◆◆◆◆◆◆◆◆◆◆◆***░****************░░░░░░░░░░░░░░░░░░░░░░░░░░░░░░░░░░░░░░░░░░░*********************************************************************************************************************************************************************
◆◆◆◆◆◆◆◆◆◆◆◆◆◆◆◆◆◆◆◆◆*********************░░░░░░░░░░░░░░░░░░░░░░░░░░░░░░░░░░░░░░░░░░░░********************************************************************************************************************************************************************
◆◆◆◆◆◆◆◆◆◆◆◆◆◆◆◆◆◆◆◆**********************░░░░░░░░░░░░░░░░░░░░░░░░░░░░░░░░░░░░░░░░░░░░********************************************************************************************************************************************************************
◆◆◆◆◆◆◆◆◆◆◆◆◆◆◆◆◆◆◆◆**********************░░░░░░░░░░░░░░░░░░░░░░░░░░░░░░░░░░░░░░░░░░░░░░******************************************************************************************************************************************************************
◆◆◆◆◆◆◆◆◆◆◆◆◆◆◆◆◆◆◆**********************░░░░░░░░░░░░░░░░░░░░░░░░░░░░░░░░░░░░░◆◆◆◆◆◆◆◆◆◆◆◆◆***************************************************************************************************************************************************************
◆◆◆◆◆◆◆◆◆◆◆◆◆◆◆◆◆◆***********************◆◆◆◆◆◆◆◆◆◆◆◆◆◆◆◆░░░░░░░░░░░░░░░◆◆◆◆◆◆◆◆◆◆◆◆◆◆◆◆◆◆◆◆◆◆◆***********************************************************************************************************************************************************
