################################################################################
#.#.........#.......#.........#.......#.....#.......#.......#...#.........#...##
#.###.#####.#.#####.#.#.#####.#####.#.#.###.#.#####.#.###.###.#.#.###.#####.#.##
#.....#.#...#.....#.#.#...#.#.....#.#.#.#.#...#...#.....#.#...#...#.#.......#.##
#######.#.#######.#.#.###.#.#####.###.#.#.#####.#.#######.#.#######.#########.##
#...#...#.......#.#...#...#.....#...#.#.#.......#...#.....#.#.#.......#.....#.##
#.###.#.#######.#.#####.###.#.#####.#.#.#.#.###.#####.#.###.#.#.#.#####.###.#.##
#.....#...#.....#...#...#.#.#.....#.#...#.#.#...#.....#.#...#...#.....#...#.#.##
#.#######.#.#########.###.#.#####.#.#.#####.#.###.#####.#.###.#######.###.#.#.##
#.#.....#...#.........#...#.....#...#.....#.#...#.#.....#...#.......#...#.#.#.##
#.###.#######.#########.#######.#########.#.#####.#.#######.#.#######.###.#.#.##
#...#.............#.#.....#...#.#.......#...#.....#...#...#.#.#.......#...#...##
###.#####.#######.#.#.###.#.#.#.###.#.#####.#.#########.#.#.#.#.#####.#.#####.##
#.#.....#.......#.#.#...#...#.#...#.#.#.....#.#.....#...#...#.#.#...#.#.#...#.##
#.#####.#########.#.###.#####.###.###.#.#####.#.###.#.#######.#.#.#.###.###.#.##
#.....#.....#.....#.#...#...#.....#...#.....#...#...#.....#...#.#.#...#...#...##
#.###.#####.#.#####.#.###.#.#######.#######.#####.#######.#.###.#.###.###.######
#...#.....#...#...#...#...#.......#.............#.#.....#.#...#.....#...#.....##
#.#.###########.#.#.###.#########.#####.#########.#.###.#.###.#########.#####.##
#.#.............#.#.#...#.#.......#...#...#.....#.#...#.#.#...#.....#...#...#.##
#.#######.#########.#.###.#.#######.#.#####.###.#.#.###.#.#.###.###.#.#.#.#.#.##
#.......#...#.......#.#...#.#.......#.......#.#.#...#...#.#...#.#.#...#...#.#.##
#####.#####.#.#######.#.#.#.###.#############.#.#####.#.#.###.#.#.#.#########.##
#...#.#.....#.........#.#.#...#...#...........#...#...#.#.#...#.#...#.........##
#.###.#.###############.#.###.#.#.#####.#.#######.#.#####.#.###.#.###.#######.##
#.#...#.........#.......#.#...#.#...#...#.#.....#.#.....#.#...#.#.#.#.......#.##
#.#.###########.#.#.#####.#.###.###.#.#####.###.#.#####.#.#####.#.#.#######.#.##
#...#...#.....#...#.#.....#...#...#.#.....#.#.#.........#.#.....#.....#.....#.##
#.###.#.###.#######.#########.###.#.#####.#.#.###########.#.#########.#.#####.##
#.#...#...#.....#.#.#.........#...#.#.....#...#.........#.#...#.......#.#...#.##
#.#.#.###.###.#.#.#.#.#########.###.#.#####.###.#######.#.###.###.#####.###.#.##
#.#.#...#.#...#...#...#...........#.#.#.....#...#.?...#.#...#...#.#.....#...#.##
#.#####.#.#.#####.#########.#######.#.#.#####.#######.#.###.###.###.#####.###.##
#...#...#...#...#.....#...#.#.#.....#.....#...#.......#.........#...#.#.......##
###.#.#.#####.#.#####.#.#.#.#.#.#########.#.###.#####.#####.#####.###.#.########
#.#.#.#.#.....#.....#.#.#.#.#.#.#.......#.#.....#.....#...#.#...#.#...#.#.....##
#.#.#.###.#####.###.#.#.#.#.#.#.#.#####.#########.#####.#.###.#.#.#.###.#####.##
#.#.#.....#...#...#.#...#.#...#.......#...#...#...#...#.#.#...#...#...#.......##
#.#.#.#####.#.###.#.#####.#########.#####.#.#.#.###.#.#.#.#.#######.#.#######.##
#...#...#...#...#.#...#.........#...#.....#.#.#.#...#.#.#...#.....#.#.....#...##
#.#######.#####.#####.#########.###.#.###.#.#.#.#.#.#.#.#####.#.###.#.#####.####
#.#.......#...#.....#.....#...#...#.#.#...#.#...#.#.#.#.#.....#.#...#.#...#.#.##
#.#.#######.#.#####.#####.#.#####.#.#.#####.#######.#.#.###.#####.###.#.#.#.#.##
#...#.......#.#...#.......#.....#.#.#.....#.........#.#...#...#...#.#...#...#.##
#####.#######.###.###########.###.#.#####.###.###########.###.#.###.#########.##
#.....#...#.......#...#.......#...#.....#.#...#.....#.....#...#.#.....#.......##
#.#####.#.#######.#.#.###.#.###.#######.#.#.###.###.#.#####.###.#.#####.#####.##
#.#.....#.#.....#.#.#.....#.#...#.....#.#...#...#.#...#.....#...#.#.....#...#.##
#.#.#####.#.###.#.#.#######.#.#####.#.#.#####.###.#######.###.###.#.#####.#.#.##
#.#.#...#.....#.#.#.#.......#.......#.#...#...#...#.....#.#...#.....#.....#.#.##
#.#.#.#########.#.#.#.###############.###.#.###.#.###.#.#.#.#########.#####.#.##
#.#.#.......#...#.#.#.............#...#.#.#.#...#.....#...#.#.....#...#...#.#.##
#.#.#####.###.###.#.#.#####.#######.###.#.#.#.###########.#.###.#.#.#####.#.#.##
#.#.#...#...#...#...#.#...#.#.......#.....#.#.....#.....#.#.....#.#.....#.#.#.##
#.#.#.#.###.###.#######.#.###.#######.#####.###.#.#.###.#########.#.###.#.#.#.##
#...#.#...#.#...#.......#...#...#.........#...#.#...#.#.....#.....#...#.#...#.##
#.###.###.#.#.###.#########.###.#############.#.#####.#####.#.#########.#.###.##
#.....#.....#.............#...................#...........#.............#.....##
################################################################################
################################################################################
