################################################################################
#?....#...........................#.........#.........#.........#...........#.##
#####.#####.#####.#############.###.#.###.###.#####.###.#####.#.###.#######.#.##
#...#.#...#.#...#...........#.#.#...#.#.#.#.......#.....#...#.#.....#...#...#.##
#.#.#.#.#.###.#.#####.#####.#.#.#.###.#.#.#.#########.###.#.#.#########.#.###.##
#.#...#.#.#...#.....#.#.....#.#.#...#.#.#.#...#.....#.....#.#.....#.....#.#...##
#.#####.#.#.#######.#.#.#####.#.#.###.#.#.#.###.###.#.###########.#.#####.#.#.##
#.#.....#...#.....#.#.#.#.......#.#...#...#.#...#.#.#.#...#.......#.....#.#.#.##
#.#####.#########.#.###.#.#######.#.#######.#.###.#.#.#.#.#.#######.###.#.###.##
#.....#...#.....#.#.....#...#.....#.#.......#.#...#.#.#.#...#.....#...#.#.#...##
#####.###.#.###.#.#########.#.#####.#.#######.#.###.#.#.#####.###.#####.#.#.#.##
#...#...#...#...#.#.......#.#.#...#.#.#.....#.#.....#.#.#.....#.#.#.....#...#.##
###.###.#####.###.#.#.#####.#.###.#.#.#####.#.###.#####.#.#.###.#.#.###.#####.##
#.....#.#...#.#.....#.......#...#.#.#...#...#...#...#...#.#.#.......#...#...#.##
#.#####.#.#.#.#########.#######.#.#.###.#.#.###.###.#.###.#.###.#####.###.#.#.##
#.......#.#...#...#...#.#.....#.#.#...#...#...#...#...#.#.#...#.#...#.#...#...##
#.#######.###.#.#.#.#.#.#.#.###.#.###.#######.###.#####.#.###.###.#.###.########
#.#.......#...#.#...#.#.#.#.....#...#...#.....#...#.....#...#.#...#...#.#.....##
#.#.#####.#####.#####.###.#########.###.#.#####.###.###.###.#.#.#####.#.#####.##
#.#...#.#.#.....#...#.....#...#.......#.#...#...#...#.....#.#.#.#...#...#...#.##
#.###.#.#.#.#####.#.#########.#.#.###.#.###.#.###.###.#####.#.#.#.#######.#.#.##
#.#.....#.....#...#...#.....#...#...#.#.....#...#...#.#...#.#...#.........#...##
#.###########.#.###.#.###.#.#######.#####.#####.###.#.#.#.#.#########.###.###.##
#.........#.#.#...#.#...#.#...#.....#...#.#.....#.#.#...#...........#...#...#.##
#########.#.#.#####.###.#.###.#.#####.#.###.#####.#.###############.#######.####
#.....#...#.#.#...#.#.#...#.#.#.....#.#.....#...........#.....#.#.........#...##
#.#####.###.#.#.#.#.#.#####.#.#####.#.#####.#############.###.#.#.#######.#.#.##
#.......#...#...#...#.....#...#...#.#.....#.#...........#.#.#.#...#...#.#.#.#.##
#.#######.#.#########.###.#.###.#.#.#####.#.#.#########.#.#.#.#####.#.#.#.###.##
#.....#...#.....#...#.#...#.#...#.......#.#.#...#.....#.....#.....#.#.#.......##
#####.#.#######.#.#.#.#.#.#.###.#######.#.#####.#.###.###########.#.#.#######.##
#.#...#.....#.#...#...#.#.#.#...#.....#.#.....#.#.#.#.#.....#...#...#.....#.#.##
#.#.#######.#.#########.###.#.###.###.#####.###.#.#.#.#.###.#.#.#######.#.#.#.##
#.#.#.....#...#...#...#...#.#.#...#.#.....#.....#.#...#.#.....#.......#.#.#.#.##
#.#.#.###.###.#.###.#.#.#.#.#.#.###.###.#########.#.###.#############.###.#.#.##
#.#.#...#...#.#...#.#.#.#.#.#.#.......#.......#...#...#.........#...#.#...#.#.##
#.#.#####.###.###.#.#.###.#.#.#.#####.###.###.###.###.#########.#.###.#.###.#.##
#.#.....#.........#.#.#...#.#...#...#...#...#.#...#...#.....#...#...#.#...#.#.##
#.#####.#########.#.#.#.###.#.###.#.#######.#.#.###.###.###.#.###.#.#.###.#.#.##
#.#...#.......#...#.#.#.....#.#...#...#.....#...#...#...#...#...#.#.......#...##
#.#.#.#######.#####.#.###.#####.#####.#.#####.#####.###.#.#####.###########.####
#.#.#.......#.......#...#.....#.....#...#.#...#...#.....#.....#.......#.......##
#.#.#####.#############.#####.###.#.#####.#.###.#.###########.#######.#######.##
#.#...#...#.......#...#.....#...#.#...#...#.#...#.#.........#.......#.....#...##
#.###.#.###.#.###.###.#####.###.#####.#.###.#.###.#.#######.###.#######.#.######
#.....#.....#...#...#.....#.#.#.......#...#.#.#.#.#...#...#.#...#.....#.#.#...##
#.#############.###.###.###.#.###########.#.#.#.#.###.#.#.#.###.#.###.###.#.#.##
#.......#...#...#.......#...#.....#.......#.#.#.......#.#.#...#.#...#...#...#.##
#######.#.###.###.#######.###.#.#.#.###.###.#.###########.###.#####.###.#.###.##
#.....#.#...#.#.#...#.....#.#.#.#.#...#.....#...#.......#...#...#...#...#.#...##
#.#.#.#.###.#.#.#.###.#####.#.#.#####.#########.#.#####.#.#.###.#.###.#####.#.##
#.#.#.#.....#.#.#.#...#.......#...........#...#...#.#...#.#.....#...#.....#.#.##
#.#.###.#####.#.#.#.###.###################.#.###.#.#.###.#########.#####.#.#.##
#.#.#...#.....#...#.#.......#.............#.#...#...#.#.#.........#.#...#.#.#.##
#.#.#.###.#####.###.#########.###########.#.###.#####.#.#########.#.#.#.#.#.####
#.#.#...#.....#...#.#.......#...#.....#...#.#.#.#.....#.........#.#...#.#.#...##
#.#.###.#####.#####.#.#####.###.#.###.#.###.#.#.#.#####.#########.#####.#.###.##
#.#.........#.........#.........#...#.......#.....#.....................#.....##
################################################################################
################################################################################
