################################################################################
################################################################################
################################################################################
################################################################################
################################################################################
################################################################################
################################################################################
################################################################################
################################################################################
################################################################################
################################################################################
################################################################################
################################################################################
################################################################################
################################################################################
################################################################################
#####################################################.##########################
#####################################################...########################
################################################################################
########################################################.#######################
###################################################....#.#######################
###################################################......#######################
###################################################..?..########################
###################################################.....########################
###################################################.....########.###############
###################################################........#####.###############
##############################################################...###############
#####################################.......####################.###############
#####################################.......####################.###############
#####################..##############.......####################.###############
#####################..########.............##########.#.#######################
#####################...#.#####.............##########...#..####################
#####################.?...##................##########.....#####################
#####################.....#####.............###########.....####################
####################......#####.............###########....#####################
#####################.....##................############....####################
#####################...#######......?......##########.#......##################
###############################..............######............#################
###############################................###.............#################
##############################......######.....###.....?........################
#############################........####.......##.............#################
###############################.....######.....##..............#################
########################.######.......####.....###............##################
######################.....####.......######.#.###..........####################
#####################.......###.......########.###.........#####################
#####################.......###.......########.####.......######################
####################....?....##.......#############.##.#########################
#####################.......###.......#############.############################
#####################.......###.......#############.############################
######################.....#####################################################
########################.#######################################################
################################################################################
################################################################################
################################################################################
################################################################################
################################################################################
################################################################################
################################################################################
################################################################################
################################################################################
