################################################################################
################################################################################
################################################################################
###########################.####################################################
#########################....###################################################
#########################...####################################################
########################....####################################################
#########################.#.####################################################
#########################.#.####################################################
################################################################################
################.###############################################################
#############.......#.##########################################################
############..........##########################################################
###########...........############################.#############################
###########...........#########################.......##########################
###########.............######################.........#########################
##########......?.......######################.........#########################
###########.............#######.##############.........#########################
###########.............#####.....###########...........########################
###########.............#####.....############.........#########################
############.........#######...?...###########.........#########################
#############.......#########.....############.........#########################
################.############.....#######.#####.......##########################
#########################.#####.#######.........##.#############################
######################.......###########.......#################################
#####################.........#########...#.....######.#########################
####################...........#######....#.......##.....#######################
####################...........######....##.#.?####..........###################
####################...........#####....###.##.####.......######################
###################......?......#####...##########.........#####################
####################...........#####....#..########.......######################
####################...........######.............#.......######################
####################...........######......###...........#######################
#####################.........##########.#.###.....###.#########################
######################.......###########.#####.....#############################
#########################.#########.......#####...##############################
###################################.......####....##############################
###################################.......######################################
###################################.......######################################
###################################.......######################################
###################################.......######################################
#################################.........######################################
###################################.############################################
#################################...############################################
################################################################################
################################################################################
################################################################################
################################################################################
################################################################################
################################################################################
################################################################################
################################################################################
################################################################################
################################################################################
################################################################################
################################################################################
################################################################################
################################################################################
################################################################################
################################################################################
