################################################################################
################################################################################
################################################################################
##############################.#################################################
##############################.......###########################################
##############################.......###########################################
####################.#########.......###########################################
#################$......######.......###########################################
################...$.....#####..$....###########################################
################.........#####.......###########################################
################.........#####.......###########################################
###############...........#####.###.############################################
################..........#####.........########################################
################..........#####.........########################################
################...........####.........########################################
#################...........*...........########################################
####################........###.........########################################
####################........###.........########################################
#####################.......###.........########################################
#########################.#####.........########################################
###############################.........#######.$.*...##########################
############################.########...#######.......##########################
###############.........####.#######.....######.......##########################
###############.........####....##.###...######.......##########################
###############.$....$..####....##.#...#.######....$..##########################
###############.........##.........###.########.......##########################
###############.........##...............######..........#######################
###############......$.*##................######################################
###############...B.....##.................#####################################
###############.........##.................#####################################
###############.........##.....................##.##############################
##########################.................B........############################
##########################.........#.................###########################
##########################......$..###.#.............###########################
###########################.##..########..............##########################
###########################.......######.............###########################
###########################.......######.............###########################
###########################.......#############.....############################
###########################.......###############.##############################
###########################.......##############################################
###########################.......##############################################
###########################.......##############################################
################################################################################
################################################################################
################################################################################
################################################################################
################################################################################
################################################################################
################################################################################
################################################################################
################################################################################
################################################################################
################################################################################
################################################################################
################################################################################
################################################################################
################################################################################
################################################################################
################################################################################
################################################################################
