################################################################################
################################################################################
######.....###...##################.....########################################
######..................................########################################
######.....##....##################......................#######################
#############.#####################.....#######...................##############
#############.#####################.....#######...................##############
#############.#########################.#######...................##############
#############.#########################.########################################
#############.#########################.########################################
#############.#########################.########################################
#############.#########################.##################################....##
#############.#############........................#######################....##
#############.#############........................#######################....##
#############.#############...................................................##
#############.#############........................#######################....##
#############.#######################.##########################################
#############.#######################.##########################################
#############.#######################.#####################################...##
#############.#######################.#####################################...##
######..............................................................#######...##
######..............................................................#######...##
######........................................................................##
######..............................................................############
#############.##################################################################
#############.##################################################################
##.......................#######################################################
##.......................###........###########......###########################
##.......................###........###########..........#######################
##.......................###........?##########......###.#######################
##.......................###........##############.#####.#######################
##.................................................#####.#######################
##.......................###........#########......................#############
##.......................###........#########......................#############
##.......................###........#########......................#############
##.......................###........#########......................#############
##.......................###........#########......................#############
########.#######################################################################
########.#######################################################################
########.#######################################################################
########.######################################################..............###
########.######################################################..............###
########.######################################################..............###
########.#############################################################.#########
########.#############################################################.#########
########.#############################################################.#########
########.#############################################################.#########
########.#####################################################................##
##.............###############################################................##
##.............###############################################................##
##.....................................................................#########
##.............#######################.#########################################
##.............######...................................########################
#####################...................................########################
#####################...................................########################
#####################...................................########################
################################################################################
################################################################################
################################################################################
################################################################################
