################################################################################
################################################################################
############...........................#########################################
############...........................#########################################
############...........................#####################..................##
############...........................#####################..................##
############...........................#####################..................##
############...........................#####################..................##
############..........................................................##.#######
############...........................#################################.#######
############...........................#################################.#######
############...........................#################################.#######
############...........................##############################.......####
############...........................##############################.......####
################..############.######################################.......####
################..############.#################################################
######.................................................#########################
######.................................................#########################
######.................................................#########################
################..##############################################################
################..##############################################################
################..##############################################################
################..##################################################.......#####
#####......................#########################################.......#####
#####......................................................................#####
#####......................#######.####?############################.......#####
#################.################.#################################.......#####
#################.################.#############################################
#################.################.#############################################
#################.###############...###########...............................##
#################.###############...###########...............................##
#################.###############.............................................##
#################.###############...###########...............................##
#################.#############################...............................##
#################.#############################...............................##
#################.##############################################################
#################.##############################################################
#################.##############################################################
#################.##################################......#################...##
#################.##################################......#################...##
###########.............############################........###############...##
###########.............############################......#.################.###
###########.............############################......#.################.###
###########.............###############################.###.################.###
########.....................................................................###
########.##.............###################################.###############...##
########.##.............###################################.###############...##
########.##.............#######################........................####...##
########.######################################........................#####.###
########.######################################........................#####.###
########.######################################........................#####.###
##.............############################################################...##
##.............############################################################...##
##.............############################################################...##
##.............############################################################...##
##.............############################################################...##
##.............############################################################...##
###########################################################################...##
################################################################################
################################################################################
